@................
.###############.
.................
.#######.#######.
................X
