@.......X
...##....
#...#..#.
#..##..#.
.........
