@........
.####.##.
....#....
.##.####.
.##.....X

