@........
####.###.
.........
.###.###.
..#......
........X
